
          ISLAND MAP
    1    2    3    4    5                 
----------------------------
1 | B  | CS | CP | RS | B  |
----------------------------
2 | B  | WF | F  | F  | B  |
----------------------------
3 | B  | V  | DF | F  | C  |
----------------------------
4 | B  | M  | P  | M  | CF |
----------------------------
5 | B  | CF | CF | WF | CF |
----------------------------
